   ████████████████████████████████████████████████████████████████████████████████████████████████████████████████████████████████████████████████████
         █        █  █     █  █        █        █  █              █        █           █  █     █  █  █  █           █                 █              █
         █        █  █     █  █        █        █  █              █        █           █  █     █  █  █  █           █                 █              █
████  █  ███████  █  █  █  █  █  ████  ████  █  █  █  ████  ████  ████  ████  ███████  █  █  █  █  █  █  █  █  █████████████  ████  ██████████  █  █  █
█     █        █        █  █     █     █     █  █  █     █  █        █     █  █  █  █  █     █  █  █     █  █  █  █  █  █        █              █  █  █
█     █        █        █  █     █     █     █  █  █     █  █        █     █  █  █  █  █     █  █  █     █  █  █  █  █  █        █              █  █  █
████  ████  ████  █  ████  ██████████  ████  █  █  █  █  ███████  ███████  █  █  █  █  █  █  ████  ████  █  █  █  █  █  ██████████  ████  ████  █  █  █
█  █  █  █  █     █  █     █     █           █        █  █           █              █     █     █  █     █  █  █           █  █  █     █  █     █  █  █
█  █  █  █  █     █  █     █     █           █        █  █           █              █     █     █  █     █  █  █           █  █  █     █  █     █  █  █
█  █  █  █  ████  █  ██████████  ████  ████  █  █  █  █  █████████████  ███████  ████  ██████████  ████  █  █████████████  █  █  █  █████████████  █  █
█     █           █        █     █     █  █  █  █  █  █  █        █     █  █     █     █  █        █  █        █              █     █  █     █     █  █
█     █           █        █     █     █  █  █  █  █  █  █        █     █  █     █     █  █        █  █        █              █     █  █     █     █  █
█  █  ████  █  ████████████████  █  ████  ████  ████  ██████████  ███████  █  ████  ████  ████  █  █  ████  ████  ████  ████  █  ████  █  █  █  ███████
█  █  █     █        █     █  █           █     █           █        █     █  █  █  █     █  █  █  █  █     █        █     █  █        █  █     █     █
█  █  █     █        █     █  █           █     █           █        █     █  █  █  █     █  █  █  █  █     █        █     █  █        █  █     █     █
████  ███████  ███████  █  █  █  ███████████████████  ███████  ███████  ████  █  ███████  █  █  █  █  █  ██████████  █  █  ███████  █  ███████  ████  █
█     █        █        █     █     █        █     █  █           █     █  █                    █        █        █  █  █           █  █        █     █
█     █        █        █     █     █        █     █  █           █     █  █                    █        █        █  █  █           █  █        █     █
███████  █  ██████████  ████  ███████  ███████  █  █  ████  ███████  █  █  █████████████████████████  ███████  █████████████  ██████████  ███████  ████
█        █  █           █           █           █  █        █     █  █           █  █     █        █  █     █     █  █  █        █           █        █
█        █  █           █           █           █  █        █     █  █           █  █     █        █  █     █     █  █  █        █           █        █
█  ███████  ████  █  ████  █  ██████████  ████  █  █  ███████  █  ██████████  █  █  █  ███████  ████  ████  █  ████  █  █████████████  ██████████  ████
█  █           █  █     █  █           █  █     █  █           █  █     █     █  █                       █     █     █           █  █  █        █     █
█  █           █  █     █  █           █  █     █  █           █  █     █     █  █                       █     █     █           █  █  █        █     █
███████  █  ████  ████  ████  ███████  █  █  ████  █  ████  ███████  ███████  ████  █████████████  █  █  █  █  ████  █  ████  █  █  █  █  ███████  █  █
█  █     █  █     █  █  █        █     █  █  █  █        █  █  █  █  █        █     █        █     █  █     █  █           █  █  █           █     █  █
█  █     █  █     █  █  █        █     █  █  █  █        █  █  █  █  █        █     █        █     █  █     █  █           █  █  █           █     █  █
█  ████  ████  █  █  ████████████████  ███████  █  █  ███████  █  █  █  ████  ██████████  █  ████  ██████████  ████  █  █  ███████  ███████  ████  ████
█        █  █  █     █     █  █                    █     █        █        █  █        █  █              █        █  █  █  █           █  █  █        █
█        █  █  █     █     █  █                    █     █        █        █  █        █  █              █        █  █  █  █           █  █  █        █
█  █  ████  ████  ████  █  █  █  █  ████  █  ███████  ███████  █  ████  █  ███████  ████████████████  █  ████  ████  █  ███████  █  █  █  █  █  ███████
█  █                    █  █  █  █     █  █        █  █        █     █  █  █     █     █  █  █        █     █  █     █  █  █  █  █  █  █              █
█  █                    █  █  █  █     █  █        █  █        █     █  █  █     █     █  █  █        █     █  █     █  █  █  █  █  █  █              █
█  █  █  ████  █████████████  ████████████████  ████  █  ████  ████  █  ████  █  ████  █  █  ███████  █  █  ████  ████  █  █  ██████████  █  █  ████  █
█  █  █     █        █        █     █        █     █  █  █  █  █  █  █        █  █                 █  █  █  █  █  █                 █  █  █  █  █  █  █
█  █  █     █        █        █     █        █     █  █  █  █  █  █  █        █  █                 █  █  █  █  █  █                 █  █  █  █  █  █  █
█████████████  █  ███████  █  █  ███████  █  █  ████  ████  ████  █  █  ████  ████  █  ██████████  █  ████  █  ██████████  ██████████  ████  ████  █  █
█  █     █     █  █        █  █  █  █     █  █  █     █  █        █     █           █  █     █     █  █        █        █     █     █        █     █  █
█  █     █     █  █        █  █  █  █     █  █  █     █  █        █     █           █  █     █     █  █        █        █     █     █        █     █  █
█  █  ████████████████  ████  █  █  █  ████  ███████  █  █  █  █  █  ████████████████  ████  ████  ████  ███████  ███████  █  ████  ████  ████  ████  █
█     █              █  █  █  █           █  █        █     █  █           █     █     █        █        █              █  █     █           █     █  █
█     █              █  █  █  █           █  █        █     █  █           █     █     █        █        █              █  █     █           █     █  █
█  ████████████████  █  █  ███████  █████████████  ███████  █████████████  ████  █  ████  ████  █  ████  ████  ████  █  ███████  █  ████  ████  ████  █
█  █              █              █  █     █     █     █     █        █     █  █  █     █     █  █  █     █     █     █           █  █        █     █  █
█  █              █              █  █     █     █     █     █        █     █  █  █     █     █  █  █     █     █     █           █  █        █     █  █
█  █  ████  ████  █  ████  ████  █  █  ███████  █  ████  █  ████  ███████  █  █  ███████  ██████████  ███████  ████████████████  █  ████  ████  █  ████
█        █  █  █  █     █  █  █        █           █  █  █     █        █        █  █  █  █        █  █  █  █     █        █  █     █  █  █  █  █     █
█        █  █  █  █     █  █  █        █           █  █  █     █        █        █  █  █  █        █  █  █  █     █        █  █     █  █  █  █  █     █
█  ███████  █  ██████████  █  ████████████████  █  █  █  █  ████  █  █  ████  █  █  █  █  ████  ███████  █  █  █  █  ████  █  █  █  █  █  █  █  █  ████
█  █  █     █        █        █              █  █        █        █  █  █  █  █  █  █  █     █        █     █  █  █     █  █     █  █     █     █     █
█  █  █     █        █        █              █  █        █        █  █  █  █  █  █  █  █     █        █     █  █  █     █  █     █  █     █     █     █
█  █  █  ████  ████  █  █  █  █  ███████  █  █  ████  █  █████████████  █  ███████  █  █  ██████████  ████  █  █  █  ████  ███████  █  ████  █  ███████
█     █  █  █  █     █  █  █        █  █  █     █     █     █  █  █  █  █        █     █  █        █     █  █  █     █  █  █  █     █        █  █  █  █
█     █  █  █  █     █  █  █        █  █  █     █     █     █  █  █  █  █        █     █  █        █     █  █  █     █  █  █  █     █        █  █  █  █
███████  █  ███████  █  ████  ████  █  ████  █  █████████████  █  █  ██████████  ████  █  █  █  ████  ████  ███████  █  ████  ████  ████  ████  █  █  █
█        █           █  █     █        █     █        █              █           █     █     █  █  █  █        █              █        █     █     █  █
█        █           █  █     █        █     █        █              █           █     █     █  █  █  █        █              █        █     █     █  █
████  █  █  █  █  █  ███████  ███████████████████  ████  ████  █  ████  ████  ████  █  █  ████  █  █  █  █  ███████  ████  █  ████  ███████  ████  █  █
█     █  █  █  █  █     █           █        █              █  █     █  █     █     █        █           █  █        █  █  █  █  █     █  █  █        █
█     █  █  █  █  █     █           █        █              █  █     █  █     █     █        █           █  █        █  █  █  █  █     █  █  █        █
████  ████████████████  █  █  ███████  ██████████  █  █  ████  ████  █  ███████  ████  █  ████  █  █  █  █  █  ███████  █  █  █  █  █  █  ████  █  ████
█              █  █     █  █  █              █  █  █  █  █     █                 █  █  █     █  █  █  █  █           █  █  █     █  █     █     █     █
█              █  █     █  █  █              █  █  █  █  █     █                 █  █  █     █  █  █  █  █           █  █  █     █  █     █     █     █
███████  ████  █  ████  █  ████  ███████  ████  ███████  ███████  █  █  ██████████  █  █████████████████████████  ████  █  ████████████████  ████  ████
█           █  █     █     █     █  █  █     █     █     █        █  █           █  █  █     █              █  █     █  █           █           █     █
█           █  █     █     █     █  █  █     █     █     █        █  █           █  █  █     █              █  █     █  █           █           █     █
█  █  ████  ███████  ████  █  ████  █  █  ███████  █  ███████  ███████  ████  ████  ████  █  ████  █  █  ████  ███████  █  ██████████  ████████████████
█  █     █  █     █  █  █  █        █  █     █  █  █        █     █        █     █  █     █        █  █     █     █     █           █  █        █  █  █
█  █     █  █     █  █  █  █        █  █     █  █  █        █     █        █     █  █     █        █  █     █     █     █           █  █        █  █  █
█  ██████████  ████  █  ████  ███████  █  █  █  █  ██████████  ████████████████  █  █  ████  ███████  ███████  █  ████  █████████████  █  ████  █  █  █
█  █        █     █                 █     █                 █     █                 █  █        █           █  █     █  █  █     █        █           █
█  █        █     █                 █     █                 █     █                 █  █        █           █  █     █  █  █     █        █           █
█  █  █  █  █  ████  █  █  █  ████  ██████████  ████  ████  █  ███████████████████  ███████  ███████████████████  █  █  █  █  ███████  ████  ███████  █
█     █  █        █  █  █  █  █        █        █     █        █           █  █              █  █  █           █  █  █        █  █     █     █     █  █
█     █  █        █  █  █  █  █        █        █     █        █           █  █              █  █  █           █  █  █        █  █     █     █     █  █
█  ████  ███████  █  █  █  █  █  ████  ██████████  █████████████  ██████████  ██████████  █  █  █  █  █████████████  █  ████  █  █  ████  ████  ████  █
█     █  █  █     █  █  █  █  █     █  █  █     █  █  █  █        █           █           █     █  █     █              █              █     █        █
█     █  █  █     █  █  █  █  █     █  █  █     █  █  █  █        █           █           █     █  █     █              █              █     █        █
████  ████  ████  ███████  ███████  █  █  ████  █  █  █  ███████  ████  ███████  ███████  █  ████  █  ████  █  ███████████████████  █  ██████████  ████
█     █  █        █        █     █  █        █        █        █     █     █           █  █              █  █        █        █     █        █  █     █
█     █  █        █        █     █  █        █        █        █     █     █           █  █              █  █        █        █     █        █  █     █
█  ████  █  ████████████████  ███████  ████  █  █  █  ████  █  ████  █  █  ███████  ███████  ████  ████  █  ███████  ████  ████  ██████████  █  ████  █
█     █        █     █        █  █  █     █  █  █  █  █     █           █        █     █        █     █  █  █  █     █  █           █  █  █     █     █
█     █        █     █        █  █  █     █  █  █  █  █     █           █        █     █        █     █  █  █  █     █  █           █  █  █     █     █
█  ████████████████  ████  █  █  █  ███████  █  █  █  ████████████████  █  ████████████████  ████████████████  ███████  ███████  ████  █  ████  ████  █
█           █        █     █  █  █           █  █  █  █  █  █  █     █  █  █              █     █              █     █        █        █     █  █     █
█           █        █     █  █  █           █  █  █  █  █  █  █     █  █  █              █     █              █     █        █        █     █  █     █
█  ███████  █  █  █  ████  ████  █  ██████████  █  █  █  █  █  ████  ████  █  █  ████  █  ████  ██████████  █  █  ██████████  ██████████  ██████████  █
█  █  █        █  █  █        █  █     █        █  █  █        █     █        █     █  █  █        █        █     █           █           █     █     █
█  █  █        █  █  █        █  █     █        █  █  █        █     █        █     █  █  █        █        █     █           █           █     █     █
█  █  ███████  ███████  █  ████  ██████████  █████████████  █  █  ████  █  █  ███████  ████  ████  ███████  █████████████  █  █  ████  ████  ████  ████
█  █  █  █     █        █  █  █        █        █     █  █  █           █  █     █     █        █        █  █              █  █  █                    █
█  █  █  █     █        █  █  █        █        █     █  █  █           █  █     █     █        █        █  █              █  █  █                    █
█  █  █  ████  ██████████  █  █  █  ████  ████  █  █  █  ████  ███████  ███████  ███████  ██████████  █  █  █  ███████████████████  ████  ███████  ████
█  █  █                 █        █  █  █  █        █  █           █           █     █  █        █  █  █  █     █                 █  █     █     █     █
█  █  █                 █        █  █  █  █        █  █           █           █     █  █        █  █  █  █     █                 █  █     █     █     █
████  █  █  ███████  ███████  ████  █  ████  █  █  ████  ████████████████  ██████████  ████  ████  █  █  ████  █  ████  █  █  █  ████  █  ████  █  ████
█        █  █  █  █  █     █  █  █     █  █  █  █  █        █        █           █  █              █  █     █     █     █  █  █  █     █  █  █        █
█        █  █  █  █  █     █  █  █     █  █  █  █  █        █        █           █  █              █  █     █     █     █  █  █  █     █  █  █        █
███████  █  █  █  ████  █  ████  ████  █  ████  ██████████  █  ████  ████  █  ████  █  ████  █  ██████████  ███████  ████  ████  ██████████  █  ███████
█        █        █     █     █           █  █  █           █  █        █  █     █     █     █        █        █     █        █  █  █           █  █  █
█        █        █     █     █           █  █  █           █  █        █  █     █     █     █        █        █     █        █  █  █           █  █  █
█  ████████████████  ██████████  ████  █  █  █  ██████████  ███████  █  ████  ███████████████████  ████  █  █  ████  █  ████  █  █  ████  ████  █  █  █
█  █     █                 █  █     █  █           █              █  █  █              █           █  █  █  █  █  █  █     █  █  █  █     █           █
█  █     █                 █  █     █  █           █              █  █  █              █           █  █  █  █  █  █  █     █  █  █  █     █           █
█  █  ████  ████  ████  ████  █  █  █  █  █  ████  █  ████  ████  ████  ███████  ███████████████████  ███████  █  ████  █  ████  █  ███████  █  ███████
█  █  █        █  █  █     █     █  █  █  █     █     █     █     █  █        █        █        █        █        █     █  █  █  █  █     █  █  █     █
█  █  █        █  █  █     █     █  █  █  █     █     █     █     █  █        █        █        █        █        █     █  █  █  █  █     █  █  █     █
█  █  █  ██████████  ████  █  █  ███████  ██████████  ███████  ████  █  ████  ███████  █  ██████████  █  ███████  ████  ████  █  █  ████  ██████████  █
█  █  █  █        █           █     █     █  █           █        █     █  █        █           █     █     █     █        █  █  █        █  █        █
█  █  █  █        █           █     █     █  █           █        █     █  █        █           █     █     █     █        █  █  █        █  █        █
█  █  ████  █  █████████████████████████  █  ███████  ████  █  █  █  █  █  █  ██████████  ████████████████  ██████████  █  █  █  ███████  █  ████  ████
█        █  █           █           █     █     █     █  █  █  █  █  █  █           █     █     █  █        █           █  █  █     █                 █
█        █  █           █           █     █     █     █  █  █  █  █  █  █           █     █     █  █        █           █  █  █     █                 █
█  ███████  ████  ████  ██████████  ████  █  █  ███████  █  ████  █  █  ██████████  ██████████  █  █  █  ███████  ██████████  █  █  █  ███████  ███████
█           █        █        █           █  █  █        █     █     █        █  █     █              █              █  █     █  █  █  █        █     █
█           █        █        █           █  █  █        █     █     █        █  █     █              █              █  █     █  █  █  █        █     █
████  ████  ████  █  ██████████  █  ███████  ██████████  █  ████  █  █  ████  █  █  ████████████████  █████████████  █  ████  █  █████████████  █  ████
█     █  █  █     █  █           █           █     █        █     █  █  █  █     █                 █  █  █              █                 █  █        █
█     █  █  █     █  █           █           █     █        █     █  █  █  █     █                 █  █  █              █                 █  █        █
███████  ███████  █  ████  ███████  ███████  █  ██████████  ███████  ████  █  ████  █  ██████████  ████  █  ████  ████  █  ███████  █  █  █  ████  █  █
█  █        █     █  █     █  █        █        █     █  █        █        █  █  █  █     █                 █  █  █     █     █  █  █  █  █  █  █  █  █
█  █        █     █  █     █  █        █        █     █  █        █        █  █  █  █     █                 █  █  █     █     █  █  █  █  █  █  █  █  █
█  ████  █  ███████  ███████  █  █  ████████████████  █  █  ██████████  ███████  ████  ███████  ████  █  ████  █  ████  ████  █  █  ███████  █  ████  █
█        █  █              █     █  █           █              █        █  █        █     █     █     █  █        █  █  █  █  █     █  █        █  █  █
█        █  █              █     █  █           █              █        █  █        █     █     █     █  █        █  █  █  █  █     █  █        █  █  █
████  █  █  █  █  ████  ███████  ████  █  ███████  ████  █  █  █  ███████  █  ██████████  █  ████  █████████████  █  ████  ███████  █  ███████  █  █  █
█     █  █  █  █  █           █  █  █  █     █        █  █  █  █  █  █  █                 █  █  █           █  █     █        █  █     █  █           █
█     █  █  █  █  █           █  █  █  █     █        █  █  █  █  █  █  █                 █  █  █           █  █     █        █  █     █  █           █
███████  ████  ███████  ███████  █  ███████  █  ██████████  █  ████  █  █  ███████  █  █  ████  █  █  ███████  █  █  ███████  █  ███████  ████  ███████
█     █  █  █  █  █              █     █     █     █     █  █  █     █  █  █  █     █  █        █  █  █  █  █     █  █        █  █  █        █     █  █
█     █  █  █  █  █              █     █     █     █     █  █  █     █  █  █  █     █  █        █  █  █  █  █     █  █        █  █  █        █     █  █
█  ████  █  ████  █  ██████████  █  █  █  ████  ███████  ███████  ████  ████  █  ███████  ██████████  █  █  ███████  █  ████  █  █  ████  ███████  █  █
█     █              █        █     █  █        █  █        █        █              █              █  █     █           █              █  █  █  █     █
█     █              █        █     █  █        █  █        █        █              █              █  █     █           █              █  █  █  █     █
█  █  ████  ████████████████  █  ███████  ███████  ████  ████  █  ████  ███████  ██████████  █  █  ████  █  █  ████  ████  █  ███████  █  █  █  █  ████
█  █              █  █     █  █     █     █           █        █        █              █     █  █  █     █  █  █  █     █  █  █  █  █  █        █     █
█  █              █  █     █  █     █     █           █        █        █              █     █  █  █     █  █  █  █     █  █  █  █  █  █        █     █
█  ██████████  █  █  █  ████  █  █  █  ████  ██████████  █  ████  ███████  ██████████████████████  █  ███████  █  ████  ███████  █  ███████  █  █  ████
█     █  █     █              █  █  █     █  █     █     █  █        █     █                       █  █           █           █  █  █     █  █  █     █
█     █  █     █              █  █  █     █  █     █     █  █        █     █                       █  █           █           █  █  █     █  █  █     █
███████  █  █  ██████████  ████████████████  ████  █  ████  █████████████  █  █  █████████████  ████  █  █  ████  ████  ████  █  █  ████  █  █  █  █  █
█     █     █  █                    █  █     █        █  █              █  █  █  █        █  █        █  █     █     █  █  █        █     █  █  █  █  █
█     █     █  █                    █  █     █        █  █              █  █  █  █        █  █        █  █     █     █  █  █        █     █  █  █  █  █
█  █  ████  ███████  ████  █  █  ████  █  █  ███████  █  █  ████  █████████████  ████  ████  █  █████████████  ████  ████  ████  █  █  ████  █  █  █  █
█  █  █  █        █  █  █  █  █        █  █     █  █  █        █  █  █              █  █  █     █  █           █  █  █        █  █        █  █     █  █
█  █  █  █        █  █  █  █  █        █  █     █  █  █        █  █  █              █  █  █     █  █           █  █  █        █  █        █  █     █  █
█  █  █  █  ███████  █  █  █  █  ██████████  █  █  █  █  ████  ████  ████  █  █  █  █  █  █  █  █  █  ████  ████  █  ████  █  █  ███████  ████  █  █  █
█  █              █     █  █  █        █     █        █     █  █           █  █  █  █        █     █  █        █           █  █     █           █  █  
█  █              █     █  █  █        █     █        █     █  █           █  █  █  █        █     █  █        █           █  █     █           █  █  
████████████████████████████████████████████████████████████████████████████████████████████████████████████████████████████████████████████████████  
